border_size=1
usage=map

Ce^Xo       , Ce^Xo       , Ce^Xo       , Ce^Xo       , Ce^Xo       , Ce^Xo       , Ce^Xo       , Ce^Xo       , Ce^Xo       , Ce^Xo       , Ce^Xo       , Ce^Xo       , Ce^Xo       , Ce^Xo       , Ce^Xo       , Ce^Xo       , Ce^Xo       
Ce^Xo       , Ce^Xo       , Ce^Xo       , Ce^Xo       , Gg          , Gg          , Gg          , Gg          , Gg          , Gg          , Gg          , Gg          , Gg          , Ce^Xo       , Ce^Xo       , Ce^Xo       , Ce^Xo       
Ce^Xo       , Ce^Xo       , Gg          , Gg          , Gg          , Gg          , Gg          , Gg          , Gg          , Gg          , Gg          , Gg          , Gg          , Gg          , Gg          , Ce^Xo       , Ce^Xo       
Ce^Xo       , Gg          , Gg          , Gg          , Gg          , Gg          , Gg          , Gg          , Gg          , Gg          , Gg          , Gg          , Gg          , Gg          , Gg          , 2 Gg        , Ce^Xo       
Ce^Xo       , Gg          , Gg          , Gg          , Gg          , Gg          , Gg          , Gg          , Gg          , Gg          , Gg          , Gg          , Gg          , Gg          , Gg          , Gg          , Ce^Xo       
Ce^Xo       , Gg          , Gg          , Gg          , Gg          , Gg          , Gg          , Gg          , Gg          , Gg          , Gg          , Gg          , Gg          , Gg          , Gg          , Gg          , Ce^Xo       
Ce^Xo       , Gg          , Gg          , Gg          , Gg          , Gg          , Gg          , Gg          , Gg          , Gg          , Gg          , Gg          , Gg          , Gg          , Gg          , Gg          , Ce^Xo       
Ce^Xo       , Gg          , Gg          , Gg          , Gg          , Gg          , Gg          , Gg          , Gg          , Gg          , Gg          , Gg          , Gg          , Gg          , Gg          , Gg          , Ce^Xo       
Ce^Xo       , Gg          , Gg          , Gg          , Gg          , Gg          , Gg          , Gg          , Gg          , Gg          , Gg          , Gg          , Gg          , Gg          , Gg          , Gg          , Ce^Xo       
Ce^Xo       , 1 Gg        , Gg          , Gg          , Gg          , Gg          , Gg          , Gg          , Gg          , Gg          , Gg          , Gg          , Gg          , Gg          , Gg          , Gg          , Ce^Xo       
Ce^Xo       , Ce^Xo       , Ce^Xo       , Gg          , Gg          , Gg          , Gg          , Gg          , Gg          , Gg          , Gg          , Gg          , Gg          , Gg          , Ce^Xo       , Ce^Xo       , Ce^Xo       
Ce^Xo       , Ce^Xo       , Ce^Xo       , Ce^Xo       , Ce^Xo       , Ce^Xo       , Ce^Xo       , Ce^Xo       , Ce^Xo       , Ce^Xo       , Ce^Xo       , Ce^Xo       , Ce^Xo       , Ce^Xo       , Ce^Xo       , Ce^Xo       , Ce^Xo       
